
########################################################################################################
#                   #                       Z #                                                        #
#                   #                         #                                                        #
#                   #                  A      #                                                        #
#             #######       ###################                                                        #
#                                                    #################################                 ##########################################
#                                                                                    #                                                      
#                                                                                    #                                                       
#               #######    ######################                                                         #######################################
#               #                    #                                                                   #
##########################################################################################################