
                                                            ###########
                                                            #         #
                         ##########                         #      Z  #
                         #        #                         #         #
                         #        #                         #         #
##########################        ###########################         # 
#                                                                     #
#                                                                     #
#                                                                     #
#                                                                     #
##########################        #######################             #
                         #        #                     #             #
                         ##########                     #             #
                                                        ####          #
                                                           #          # 
                                                           #          #
